########################################
#    #                            #    #
# ####                            #### #
#            ##############            #
###                                  ###
#       ##                    ##       #
#                                      #
#          ########  ########          #
#                                      #
#  #####                        #####  #
#             ############             #
#           ###          ###           #
#      #                        #      #
#    ############      ############    #
########################################
#    #                            #    #
# ####                            #### #
#            ##############            #
###                                  ###
#       ##                    ##       #
#                                      #
#          ########  ########          #
#                                      #
#  #####                        #####  #
#             ############             #
#           ###          ###           #
#      #                        #      #
#    ############      ############    #
########################################
