########################################
#                                      #
#      #                        #      #
#      #                        #      #
# ######         ######         ###### #
#                                      #
#                                      #
#      ######              ######      #
#                                      #
#                                      #
###                                  ###
#               ########               #
#                                      #
#                                      #
#####                              #####
#        ####              ####        #
#           ################           #
#                                      #
#                                      #
########                        ########
###########     ########     ###########
########################################
########################################
