####################
#                  #
#     #######      #
# ##               #
#         ######   #
#   ##             #
#                # #
# ##               #
#    #########     #
#                  #
#                ###
#                  #
#         ####     #
#                  #
####################